1111111111111111111111111111
1000000!00000000000P00000001
1000000000000000000000000001
100000000000C000000E00000001
1000000000000000000000000001
1000000000000000000000000001
1000000000000000000000000001
1111111111111111111111111111