11111111111111111111111111111111111111111111111111111111111111111111111111111111111
10P00000000000000000000000000011111111111111111111111111111111111111111111111111111
10000000000000000000000000000011111111111111111111111111111111111111111111111111111
10000000000000000000000000000011111111111111111111111111111111111111111111111111111
10000000000000000000000000000011111111111111111111111111111111111111111111111111111
100000000000000E0000000000000011111111111111111111111111111111111111111111111111111
10000000000000000000000000000011111111111111111111111111111111111111111111111111111
10000000000000000000000000000011111111111111111111111111111111111111111111111111111
10000000000000000000000000000011111111111111111111111111111111111111111111111111111
10000000000000000000000000000011111111111111111111111111111111111111111111111111111
10000000000000000000000000000011111111111111111111111111111111111111111111111111111
10000000000000000000000000000011111111111111111111111111111111111111111111111111111
10000000000000000000000000000011111111111111111111111111111111111111111111111111111
10000000000000000000000000000011111111111111111111111111111111111111111111111111111
10000000000000000000000000000011111111111111111111111111111111111111111111111111111
10000000000000000000000000000011111111111111111111111111111111111111111111111111111
10000000000000000000000000000011111111111111111111111111111111111111111111111111111
10000000000000000000000000000011111111111111111111111111111111111111111111111111111
10000000000000000000000000000011111111111111111111111111111111111111111111111111111
10000000000000000000000000000C11111111111111111111111111111111111111111111111111111
11111111111111111111111111111111111111111111111111111111111111111111111111111111111
11111111111111111111111111111111111111111111111111111111111111111111111111111111111