111111111111111111
10P000000000000001
111111111111110001
1000000000C0000001
100011111111111111
100000000000000001
100000000000000E01
111111111111111111