111111111111111111
10000P000000000001
111111111111110C01
100000000000000001
100011111111111111
1000000000C0000001
1000000000000000E1
111111111111111111