1111111111111111111111111
10000000000000000000000P1
1011111111111111111111111
10000000000000000001000E1
1000000110110000000100001
100000010C010000000000001
1111111111111111111111111