1111111111111111111111111111111111111111
1P000000000000000000000000000000000000C1
1111111111111111111111111111110011111111
1000000000000000000000000000000000000001
1000000000000000000000000000000100000001
1000000000000000000000000000000100000001
100000000000000000000000000000010C0C0C01
1000000000000000000000000000000111111111
1011111100000000000000000000000000000001
1000000100000000000000000000000000000E01
1000000100000000000000000000000000000001
1E00000100000000000000000000000000000001
1111111111111111111111111111111111111111